#################################################################################
#.#...#....$....#...................#...#.........#.......#.............#.......#
#.#.#.#.###.###.#########.#########.#.#####.#####.#####.#.#.#######.###.#.#####.#
#...#.....#...#.#.........#.#.....#.#...#...#...#.......#.#.#.......#.#.#.#...#.#
#############.#.#.#########.#.###.#.###.#.###.#.#.#######.###.#######.#.#.#.#.#.#
#...........#.#...#.#.....#...#...#...#.#.#.#.#...#...#.......#.......#.#.#.#.#.#
#.#########.#.#####.#.#.#.#.###.#####.#.#.#.#.#####.#.#########.###.###.###.#.#.#
#.#.........#...#...#.#.#.#...#.....#.#.#.#...#.#...#.......#.....#.#...#...#...#
#.#########.#.#.###.#.#.#####.###.#.#.#.#.#.###.#.#########.#####.#.#.###.#####.#
#.#.......#.#.#...#...#.#.....#.#.#.#...#.#.....#.#.....#.#...#...#.......#...#.#
#.#.#####.#.#.###.#####.#.#####.#.#.###.#.#######.###.#.#.###.#.###########.#.#.#
#...#...#.#.#...#.....#.#.......#.#.#...#.....#...#...#.....#.#.#...#...#...#...#
#####.#.#.#.#########.#.#######.#.###.#######.#.###.#########.###.#.#.#.#.#######
#.....#...#.#.........#.......#.#...#.#.#.....#.#.....#.......#...#.#.#.#.#.....#
#.#########.#.#########.###.###.###.#.#.#.###.#.#.###.#.#######.###.#.###.#.###.#
#...#.#.....#...#.....#.#.#...#.#.#.....#...#.#.#...#.#...#...#...#.#.#...#...#.#
###.#.#.#####.#.#.#.###.#.###.#.#.#####.###.###.#####.###.#.#.#.###.#.#.#####.#.#
#...#...#.....#.#.#.#...#...#.....#...#.#...#...........#.#.#...#...#.......#.#.#
#.###.#########.#.#.#.###.#.#####.#.#.###.###.###########.#.#####.#########.###.#
#.#.............#.#.......#.#...#.#.#...#.#...#.#.......#.......#.#...#.....#...#
#.#.#############.#########.#.#.###.###.#.#.###.#.#####.#.#######.#.#.#.#####.#.#
#.#.#...........#.#.#.#.....#.#.....#...#.#.....#...#.#.#.#.#...#.#.#.#.#.....#.#
#.###.#########.#.#.#.#######.#######.###.#####.###.#.#.#.#.###.#.#.#.#.#####.#.#
#.....#...#.....#...#.........#.....#...#.....#...#...#.#.....#.#...#.#.#.....#.#
#.#####.#.#.#######.###########.#######.#.#######.###.#.###.###.#####.#.#.#####.#
#.....#.#.#...#...#.#.......#.........#.#...#.......#.#.#...#...#.....#.#.#...#.#
#######.#.###.#.###.#.#####.#.#####.###.#.#.#.#######.#.#####.###.#####.#.###.#.#
#.......#.#...#.....#.#...#.#...#.#.....#.#.#.#.#.....#...#...#...#.....#...#.#.#
#.#######.#.#.#####.#.###.#.###.#.#######.#.#.#.#.#######.#.###.#.###.#####.#.#.#
#.#.#.....#.#.#...#.#...#.#...#...#.#...#.#...#.#.....#.#...#...#...#.......#...#
#.#.#.#####.#.#.#.#####.#.###.###.#.#.#.#.#####.#####.#.#####.#####.#########.###
#.#...#.....#.#.#.#...#...#.#.#...#...#.#.#...#.....#...#.#...#...#.....#...#.#.#
#.###.###.#.###.#.#.#.###.#.#.#.#######.#.#.#.#####.###.#.#.###.#.#####.###.#.#.#
#...#...#.#.#...#.#.#...#.#.#.#.#.......#...#.........#.#...#...#.#...#...#.#...#
#.#.###.#.#.#.###.#.###.#.#.#.#.###.###.###########.###.#.###.###.###.###.#.###.#
#.#...#.#.#.#...#...#...#.#.#.#.....#...#...#.....#.#...#.....#.....#.#...#...#.#
#.###.#.#.#####.#####.#.#.#.#.#######.###.#.#####.#.#.#############.#.#.###.#.#.#
#...#.#...#...#.....#.#.#.#.#.#...#...#.#.#.......#.#.#...#...#...#...#.#.#.#...#
###.#.#####.#.#####.#.###.#.#.#.#.#.###.#.#########.#.#.#.#.#.#.#.#####.#.#.#####
#...#.......#.......#.......#...#.......@...........#...#...#...#.......#.......#